0000000000000000000000
0                    0
0              B     0
0  A                 0
0                    0
0    123333333321    0
0                    0
0         .          0
0                    0
0                    0
0    123333333321    0
0                    0
0                 A  0
0     B              0
0                    0
0000000000000000000000