0000000000000000000000
0           1        0
0           1        0
0           1        0
0  B        1    .   0
0           1        0
0           6        0
012345     6         0
0         6     543210
0        6           0
0  C     1           0
0        1           0
0        1           0
0   B    1        C  0
0        1           0
0000000000000000000000