0000000000000000000000
0                    0
0 .                D 0
0  6  6  6  6  6  6  0
0                    0
0                    0
0  6  6  6  6  6  6  0
0                    0
0                    0
0  6  6  6  6  6  6  0
0                    0
0                    0
0  6  6  6  6  6  6  0
0 D                D 0
0                    0
0000000000000000000000