0000000000000000000000
0                    0
0       D            0
0         2     C    0
0         6          0
0         6        D 0
0   B     6          0
0  2222666266622222  0
0         6          0
0A        6     .    0
0         6          0
0         2          0
0    C    2          0
0           A     B  0
0                    0
0000000000000000000000