0000000000000000000000
0                    0
0   .   1          B 0
0      11            0
0     11             0
0    11              0
0    1        1      0
0             1      0
0             1   E  0
0             1      0
0                    0
0  1111111           0
0                    0
0 B           E      0
0                    0
0000000000000000000000