0000000000000000000000
0      3             0
0  E   3             0
0      3    3        0
0      7    3      E 0
0   1277    7        0
0           7721111110
0                    0
0         E          0
0  E         77211   0
01111277     7       0
0      7     3       0
0   .  3     3  E    0
0            3       0
0            3       0
0000000000000000000000