0000000000000000000000
0                    0
0                    0
0  .                 0
0    1               0
0   13               0
0                    0
0                    0
0                    0
0                    0
0               31   0
0               1    0
0                 F  0
0                    0
0                    0
0000000000000000000000