0000000000000000000000
0000000000000000000000
0000000000000000000000
0                  A60
0                   E0
0    6 C     6       0
0    2       2    F  0
0    2       2       0
0 .  2       2       0
0    2       2    F  0
0    6 C     6       0
0                   E0
0                  A60
0000000000000000000000
0000000000000000000000
0000000000000000000000